Александровское=Александровское АС
Благодарный/Ставр/=Благодарный АС
Буденновск=Буденновск АС
Дивное=Дивное Ост.пункт
Зеленокумск АВ=Зеленокумск Ост.пункт
Изобильный=Изобильный АС
Ипатово=Ипатово Ост.пункт
Кочубеевское АС=Кочубеевское Ост.пункт
Красногвардейское АС=Красногвардейское Ост.пункт
Курсавка=Курсавка Ост.пункт
Левокумское АС=Левокумское Ост.пункт
Михайловск=Михайловск Кассовый пункт
Невинномысск=Невинномысск АС
Нефтекумск АС=Нефтекумск Ост.пункт
Новотроицкая Ставр.=Новотроицкая Ост.пункт
Рыздвяный=Рыздвяный Ост.пункт
Светлоград=Светлоград Ост.пункт
Ставрополь=Ставрополь АВ
Абинск АВ=Абинск
Адыгейск=Адыгейск АК
Анапа АВ=Анапа
Апшеронск АВ=Апшеронск
Архипо_Осиповка АК=Архипо-Осиповка
Астрахань=Астрахань АВ
Баксан АВ=Баксан
Баку=Баку АВ
Белореченск АВ=Белореченск
Беслан=Беслан АС
Бетта АК=Бетта
Верхний Мамон ( трасса)=Верхний Мамон трасса
Владикавказ=Владикавказ АВ 1
Волгоград=Волгоград Центральный АВ
Волгодонск=Волгодонск АВ
Волна АП/центр/=Волна
Воронеж /трасса/=Воронеж трасса
Воронеж тех.ост.=Воронеж тех. остановка
Геленджик АВ=Геленджик
Георгиевск=Георгиевск АВ
Гиагинская=Гиагинская АК
Горячий Ключ АП/трасса/=Горячий Ключ трасса
Грозный=Грозный АВ Западный
Джубга АС=Джубга
Дивноморское/центр/=Дивноморское
Дмитриевское/Ставр/=Дмитриевское Ост. пункт
Донецк АВ "Южный"=Донецк АВ "Южный" Украина
Ейск АВ=Ейск
Ессентуки=Ессентуки АВ
Ефремов=Ефремов АВ
Зеленчукская=Зеленчукская АВ
Избербаш=Избербаш АС
Изварино АПП Укр.=Изварино АПП
Инал АК=Инал
Кабардинка АК=Кабардинка
Казбеги АПП=Казбеги
Карачаевск=Карачаевск АВ
Кардонинская=Кардоникская АС
Кисловодск=Кисловодск АВ
Кореновск АК=Кореновск
Котельниково=Котельниково АК
Кошехабль=Кошехабль АС
Красный Октябрь АП /трасса/=Красный Октябрь трасса
Красочный /Ставр/=Красочный Ост. пункт
Крымск АС=Крымск
Курганинск АС=Курганинск
Кущевская АС=Кущевская
Лабинск АВ=Лабинск
Ладовская Балка=Ладовская Балка АК
Ладожская АП/трасса/=Ладожская
Лазаревское АК=Лазаревское
Ленинградская АС=Ленинградская
Майкоп=Майкоп АВ
Мариновка АПП=Мариновка
Мариуполь АВ=Мариуполь
Махачкала АВ=Махачкала АВ Северный
Миллерово=Миллерово АВ
Минеральные Воды АВ=Минеральные Воды АВ 1
Молькино АП /трасса/=Молькин
Москва/АВ Южные Ворота/=Москва АВ Южные ворота
Москва/Красногвардейская/=Москва Красногвардейская АС
Москва/Орехово/=Москва ст м Орехово
Москва/Щелковский ав/=Москва Щелковский АВ
Назрань=Назрань АВ
Нальчик=Нальчик АВ
Натухаевская/центр/=Натухаевская
Николаев АВ=Николаев
Новоазовск АС=Новоазовск
Новоалександровск/трасса/=Новоалександровск трасса
Новомихайловский АК=Новомихайловский
Новороссийск АВ=Новороссийск
Новочеркасск=Новочеркасск АВ
Новошахтинск=Новошахтинск АВ
Одесса АВ=Одесса
Одесса АВ /Привоз/=Одесса Привоз
Октябрьский (Волг)=Октябрьский АВ Волгоград
Отрадная АС=Отрадная
Павловская ас=Павловская
Песчанокопское=Песчанокопское АС
Полтавская АК=Полтавская
Понежукай=Понежукай АК
Порт Кавказ АК=Порт Кавказ
Преградная=Преградная АВ
Приморско_Ахтарск АС=Приморско-Ахтарск
Приютное=Приютное АС
Пролетарск=Пролетарск АС
Прохладный=Прохладный АВ
Пятигорск=Пятигорск АВ 1
Ростов АВ=Ростов-на-Дону АВ
Ростов/ трасса/=Ростов-на-Дону трасса
Рязанская АК=Рязанская
Саки=Саки АС
Сальск=Сальск АВ
Сергиевское/Ставр/=Сергиевское АК
Староминская АС=Староминская
Старощербиновская/центр/=Старощербиновская
Тамань АК=Тамань
Тарумовка=Тарумовка АП
Тахта=Тахта Ост. пункт
Тбилиси=Тбилиси АВ
Тбилисская АС=Тбилисская
Темижбекский с/з=Темижбекский
Темрюк АС=Темрюк
Тимашевск АВ=Тимашевск
Усть_Лабинск АВ=Усть-Лабинск
Чугуев=Чугуев АС
Шахты=Шахты АВ
Элиста=Элиста АВ
Яраг-Казмаляр АПП=Яраг-Казмаляр
Яшкуль=Яшкуль АС